0 1 7 66,26,60,93,74,69,87,33,3,96,85,7,70,46,10,39,58,49,80,90,81,83,16,65,72,6,27,94,48,95,22,1,38,63,97,86,57,34,84,42,51,24,40,32,61,71,53,50,12,2,36,43,73,5,18,15,59,23,41,52,77
1 1 0 67,33,89,85,46,86,1,55,73,82,15,92,78,41,18,83,62,10,27,29,98,57,3,72,70,7,0,39,51,17,19,28,76,74,21
2 0 9 26,99,18,22,79,38,39,14,80,88,17,73,82,52,66,10,91,77,36,15,76,33,4,46,89,12,72,83,47,97,13,30,58,49,75,5,45,9,25,37,59,34,67,69,56,2,93,68,19,32,41,78,27,48
3 1 7 15,8,59,46,11,19
4 0 5 46,40,34,8,7,33,58,24,76,41,70,14,15,2,50,91,35,92,57,26,51,4,0,65,88,56,54,61,16,82,3,44
5 1 3 87,97,19,75,35,8,2,84,9,95,94,53,63,28,96,11,10,56,17,78,71,43,61,34,52,26,76,50,29,22,81,99,6,30,15,0,51,67,27,12,73,66,57,83,25,85,16,62,86,80,69,91,74
6 0 7 36,55,11,70,94,93,69,82,45,22,13,25,53,60,91,46,33,0,54,77,26,18,78
7 1 1 28,75,78,10,11,90,44,53,35,64,66,0,59,63,87,73,16,88,17,20,47,50,2,6,23,24,51,58,65,45,21,32,39,96,93,37,80,94,14,48,95,12,43,5,18,9,98,8,1,60,68,84,76,82,19
8 0 5 18,8,34,9,75
9 1 3 34,67,91,92,95,3,57,49,51,74,22,86,61,19,76,79,83,43,25,31,48,2,11,10
10 1 10 96,15,78,87,59,65,17,3,85,50,64,56,5,39,89,21,12,98,28,97,93,16,44,60,81,75,11,46,99,83,91,36,41,82,54,24,79,67,86,22,8,90,55,2,29,77,51,43
11 0 1 83,32,91,81,37,40,88,45,33,64,28,38,56,63,10,31,90,35,57,66,60,62,59,48,6,21,19,17,2,89,77,5,27,36,42,1,4,82,3,94,41,65,96,51,16,30,99,93,70,46,49,14,25,13,58,98,76
12 1 8 10,85,70,31,62,8,49,79,28,89,27,90,61,64,57,5,4,96,69,6,25,39,1,13,14,63,87
13 0 10 72,36,16,35,7,51,47,66,85,37,10,12,25,96,92,0,20,70,3,27,54,81,90,77,79,61,45,13
14 1 2 18,31,24,30
15 1 6 74,58,68,28,80,72,14,95,17,2,59,73,97,57,19,4,40,10,55,75,29,88,50,71,85,90,81,25,36,8,99,78,22,44,23,42,67,3,33,84,87,70,18,11,52,49,60,62
16 0 2 1,53,68,6,16,35,40,62,70,59,42,94,54,77,99,90,75,83,37,30,67,78,50,64,92,65,80,66,39,20,41,52,60,38,48,31,74,61,55,13,71,27,57,91,19,22,0,69,29,36,24,44,7,63,12,87,79,89,72,21,14
17 1 0 31,26,77,78,87,16,89,38,63,90,7,56,41,43,69,55,5,6,79,17,80,21,62,68,2,1,3,32,47,36,14,13,86,37,83,70,94,12,92,84,15,98,24,76,67,52,61,49,33
18 0 3 19,59,35,38,73,80,23,87,20,77,72,7,0,12,10,86,46,69,47,31,9,30,41,62,93,68,66,79,85,50,1,65,17,51,56,58,78,22,63,83,75,60,24,15,67,53,43,13,8,18,71,45,57,2,37,96,64,44,36,49
19 0 4 90,82,57,17,53,97,9,46,14,11,38
20 0 9 34,15,27,21,43,55,12,90,26,65,67,13,94,62,36,69,87,50,92,93,38,39,0,54,6,40,89
21 0 6 84,19,61,75,76,83,6,34,72,25,31,24,58,65,13,81,56,73,15,27,37,62,2,87,51,99,50,44,60,39,89,64,93,43,71,42,97,30
22 0 0 36,51,27,24,87,85,63,89,52,0,58,65,72,73,99,28,91,56
23 0 9 76,93,60,29,7,70,30,91,73,8,81,72,51,28,61,40,36,54,52,25,55,17,84,23,0,85,48,47,12,53,46,31,65,95,63,43,83,27,71,9,87,82,38,16,68,66,26,57,3,92,77,78,2,62,39,74,75,4,56
24 1 3 2,65,0,26,53,15,59,9,20,24,47,57,28,75,85,35,13,34,42,98,31,97,5,1,92,90,87,23
25 1 2 96,41,42,99,39,8,26,80,91,17,66,92,49,43,59,34,25,1,40,64,22,68,55,16,28,10,86,47,89
26 0 3 82,81,38,75,27,20,79,59,36,65,67,43,18,3,72,66,49
27 0 10 62,56,45,40,29,87,71,3,64,78,34,72,33,32,11,50,25,86,55,6,7,85,39,79,14,84,98,69,83,9,90,65,58,23,12,95,5,48,53
28 0 6 92,98,13,60,79,28,78,74,43,50,70,80,65,73,20,1,55,94,6,75,27,86,21,91,39,10,53,64,96,45,5,33,18,49,51,95,56,23,48,4,36,44,89,72,12,62,40,3,81,47,84,59,16,9,69,35,38,67,54,66,8,37
29 1 8 76,64,90,22,75,23,14,50,34,99,0,70,11,9,53,79,21,42,93,15,18,82,33,87,95,58,57,8,3,89,19,30,28,55,7,61
30 1 10 60,43,56,25,47,35,78,92,91,67,98,74,88,70,69,49,72,21,29,13,66,94,76,81,23,75,83,33,46,31,53,84,85,10,5,24,4,41,34,16,38,32,7,20,79,62,68,90,80,39,48,0,27
31 0 6 93,50,18,22,35,21,76,51,36,57,14,56,43,65,69,75,73,41,81,77,31,10,37,89,19,92,97,42,55,20,34,64,45,29,26,91,8,2,3,7,38,67,80,47,46,28,0,59,79,5,78,11,63,60,48,32,4,25,54,24,85,96,83
32 0 0 74,27,21,47,79,66,91,69,43,12,40,57,30,26,34,24,92,48,51,17,5,14,83,88,13,50,59,2,53,52,37,71,85,39,64,10,80,73,45,58,61,95,16,98,28
33 0 2 27,95,49,24,48,75,51,72,92,11,25,33,78,58,69,57,90,15,66,1,56,99,42,46,14,29,68
34 0 4 38,55,49,57,83,9,95,70,89,50,97,66,64,48,5,10,73,43,42,47,90,21,39,17,80,59,72,15,4,91,87,41,46,37,58,79,19,92,11,32,34,68,94,51,61,98,28,71,52,30,25,86,77,7,81,99,56,35
35 0 1 51,98,2,20,92,85,36,87,60,12,32,76,74,52,82,72,29,58,70,81,54,75,3,8,15,61,79,77,19,69,99,93,91,31,65,49,96,4,95,89,33,16,88,90,40,55,11,41
36 0 0 5,22,65,44,40,77,15,52,98,82,94,56,60,45,32,90,18,23,11,8,0,47,38,17,49,85,24,12,87,55,43,91,75,66,28,80,2,42,54,69,58,14,51,13,93,86,20,16,36,79,41,39,68,26,67,59,30,1,81
37 1 6 23,13,56,2,78,15,52,76,1,43,55,6,94,92,42,79,50,89,51,11,31,7,8,57,62,73,45,46,90,91,66,34,88,3,53,26,60,49,84,47,48,10,5,36,74,16,29,28,86,33,59,64
38 0 9 97,24,0,21,68,49,44,59,40,95,10,46,78,69,47,17,16,25,42,14,27,57,65,73,82,52,32,75,62,11,98,28,30,29,88,70,7,13,19,86,63,39,67,61,3,66,91,90,4,64,72,99,23,53,2,51
39 0 10 57,87,52,84,67,63,15,96
40 1 8 85,29,38,96,88,31,17,26,89,46,13,18,80,71,50,64,12,97,75,47,19,28,7,82,44,8,34,6,54,57,30,5,32,70,25,86,62,1,27,79,16,22,78,43,51,98,41,33,20,11,87,39,74,99,73,58,61,45,95,93,69
41 0 10 95,44,10,79,61,68,29,84,96,34,11,94,13,45,4,98,24,50,67,19,6,59,51,86,20,8,65,99,85,54,49,9,17,80,76
42 0 0 74,79,62,48,80,90,26,29,91,17,54,82,64,23,49,5,33,93,24,1,50,7,72,47,10
43 0 4 24,95,10,32,75,91,66,36,93,63,2,1,87,3,28,88,73,48,37,20
44 0 3 23,69,95,67,28,98,79,85,66,11,39,70,21,1,2,37,92,90,75,46,12,68,30,62,86,27,0,22,87,76,26,61,78,54
45 0 7 21,25,61,46,92,42,30,40,99,84,54,56,13,70,57,27,74,98,44,38,82,73,15,3,7,80,49,81,95,90,20,16,91,97,52,55,76,68
46 0 4 6,18,81,89,0,13,56,76,91,61,94,73,44,51,54
47 1 7 15,93,11,3,28,13,85,73,96,43,88,22
48 1 10 38,60,70,59,14,83,10,66,5,52,53,41,81
49 0 2 18,20,44,46,51,2,75,63,91,15,34,37,29,48,6,92,40,55,19,21,24,84,0,67,49,10,94,33,31,79,83,93,99,50,3,66,80,32,11,5,88,35,70
50 0 5 11,52,66,21,50,69,62,84,29,48,91,58,3,33,57,47,43,32,83,23,40,99,12,81,31,8,97,67
51 0 6 11,95,63,29,4,5,55,40,14,31,51,30,28,24
52 0 0 82,30,31,79,59,93,41,12,18,42,98,69,78,4,19,1,13,15,72,48,63,88,38,27,80,22,71,91,26,61,6,73,99,47,67,35,45,87,49,25,53,46,32,57,33,96,62,68,23,14,58,36,77,90,8
53 1 1 49,87,68,2,29,71,20,37,54,57,36,70,26,59,48,21,81,38,24,15,56,44,80,11,73,41,8,64,22,93,69,76,96,60,74,61,19,31,84,16
54 0 5 37,78,58,85,47,56,66,12,11,30,81,95,93,4,67,60,23,39,43,61,96,52,86,24,63,17,91,98,79,49,15,26,19,64,3,84,34,10,70,54,57
55 1 0 26,27,74,57,13,67,62,4,21,46,63,35,78,49,80,95,68,92
56 0 1 21,91,84,66,83,45,19,93,4,52,18,44,73,74,40,47,28,42,30,69,17,87,29,82,16,11,96,64,20,32,57,48,60,6,49,41,70
57 1 3 42,21,33,26,19,14
58 1 8 67,28,32,47,8,76,13,88,34,4,38,57,62,93,29,60,24,66,7,83,12,78,21,9,48,42,14,95,69,77,84,41,22,16,59,33,39,6,27,87,20,11,96,44,0,3,75,71,73,54,63,90,45,49
59 0 9 55,25,95,85,19,78,15,49,0,27,8,26,53,82,47,99,59,22,64,12,77,42,16,6,83,74,94,98,97,60,38,36,32,89,18,68
60 0 3 62,78,25,56,91,80,67,2,61,60,94,98,15,49
61 0 3 52,57,84,5,69,87,8,56,55,76,60,93
62 1 2 59,49,8,67,30,27,58,3,40,24,54,47,18,34,31,61,78,48,68,28,92,82,32,79,71,76,43,12,36,74,98,45,62,75,80,37,6,55,33,64,60,65,89,17,53,99,7,38,14,66,77,23,22,35,94,93,52,72,13,19
63 1 2 47,27,48,69,6,25,37,90,23,10,34,18,93,2,38,99,44,22,88,31,5,57,72,84,30,61,26,46,50,0,40,16,59,1,43,92,32,97,3,91,45,49,9,62,68,95,85,29,64,96,55,4,28,19
64 0 7 57,60,85,44,92,72,25,35,33,19,40,10,18,66,8,98,59,11,50
65 1 3 74,90,56,85,43,49,88,40,97,79,66,95,67,7,81,4,63,37,18,70,60,98,83,44,69,42,80,31,61,77,3,45,41,68,10,9,99,76,84,38,47,78,34,13,11,28,16,65,64,5,50,57,36,72,48
66 1 4 28,51,59,95,81,19,36,37,46,87,8,66,11,14,97,32,38,68,82,1,12
67 0 4 57,72,93,58,75,71,61,36,46,42,67,23,60,44,13,47,88,45,7,86,84,29,79,28,38,16,35,39,43,63,92,22,54,34,89,99,82,25,76,17,55,26,80,64,85,51,24,32,14,37,73,68,96,11,90,77,19,33,94,98,49,10
68 1 9 21,41,87,61,8,48,81,60,76,51,71,19,37,79,13,0,42,93,68,22,98,73,10,55,92,59,63,2,62,28,16,67,69,72,36,74,50,6,11,90,34,88,24,57,4,7,40,95,18
69 0 2 59,73,4,2,50,74,20,94,23,76,64,36,67,37,68,0,35,16,52,5,14,51,45,53,90,91,82,54,70,49,17,71,6,28,40,21,72,85,24,41,27,63,39
70 0 6 23,92,81,96,89,20,31,50,32,99,76,27,83,54,65,56,79,5,2,98,85,90,43,97
71 1 1 51,62,69,84,21,98,26,65,31,55,16,6,2,1,93,35,72,9,64,92,24,67,96,49,60,42,29,37
72 1 5 72,88,90,17,34,50,60,96,5,28,66,54,41,84,29,67,46,38,7,22,75
73 0 9 94,16,32,56,45,43,54,13,14,59,42,20,91,44,92,60,72,76,36,18,81,75,5,85,84,41,27,62,52,86,25,87,78,19,67,74,50,4,83,49,11,8,98,22,89,39,9,48,24,40,46,38,61,7,55,33,6,80
74 0 2 43,40,48,21,90,2,80,39,11,36,71,76,87,88,3,91,23,20,85,47,73,99,26,5,56,66,98,58,97,13,93,62,84,17,81,57,4,10,50,42,53,49,92,8
75 0 1 20,84,4,11,25
76 1 4 2,50,71,84,86,54,56,85,89,65,15,4,35,60,97,1,25,63,17,99,66,80,46,12,49,77,83,39,26,27,36,78
77 0 4 88,71,97,41,73,74,56,89,51,47,94,46,58,78,4,26,31,21,67,7,42,30,24,72,93,36,77,48,65,91,20,0,9,69,37,18,13,84,75,85,19,22,59,70,29,45,10,15,83,57
78 1 2 76,86,14,44,63,18,56,62,57,70,32,42,91,80,87,2,71,35,25,69,30,83,19,89,53,11,17,39,20,13,74,48,50,95,51,65
79 1 4 74,51,73,24,58,93,69,89,90,2,19,67,36
80 0 10 48,82,7,26,94,66,49,2,88,95,21,41,72,31,43,3,4,75,17,53,60,13,93,20,73,68,44,57,8,47,33,23,24,1,46,45,30,6,5,99,11,59,92,78,89,63,77,32,79,27,83,15,70,96,58,0,67,51,86,84,85,36,34,10,14,80
81 1 2 83,0,3,59,2,86,4,55,95,19,69,73,31,65,32,91,67,33
82 0 8 12,92,31,85,61,75,82,52,96,69,14,44,24,71,48,93,72,9,60,84
83 1 5 13,4,93,40,69,44,29,94,50,59,38,15,14,17
84 0 5 9,27,15,42,90,23,50,70,69,61,41,56,7,34,62,22,46,32,33,16,52,83,38,31,47,36,82,66,53,48,64,28,13,12,89,78,2,92,84,43,6,75,74,97,85,99,49,59,72,77,10,45,63,86,95,67,14,5,71,81,98
85 1 1 25,53,19,15,84,58,30,48,85,37,64,86,52,0,80,67,26,24,55,17,42,40,57,10,74,20,71,22,87,4,35,27,88,62,6,92,63,34,36,16,31,49,14,60,12,46,41,29,97,59,18,61,65,50,13,38,96,90,51,2,44,94,23,79
86 1 6 29,11,71,6,25,22,9,77,0,90,64,41,7,87,93,85,92,44,51,94,83,36,30,20,63,52,23,4,82,26,97
87 1 3 65,81,70,55,97,34,52,51,40,92,59,86,35,57,99,12,9,88,46,37,96,67,29,66,21,47,45,63,74,11,84,14,19,76,68,87,6,27,82,54,2,91,93,42,79,80,1,3,30,64,8,71,18,61,62
88 1 8 71,21,42,69,28,58,94,17,7,84,79,1,47,35,50,61,39,0,72,32,91,23,24,89,67,92,3,29,9,74,82,85,45,2,16,57,63,34,66,54,65,12,60,70,80,86
89 1 8 29,65,70,22,57,13,30,58,1,63,92,69,96,97,79,64,48,47,35,54,19,53,84,62,95,8,38,32,74,55,40,59,9,5,80,61,11,28,46,31,26,73,68,81,60,85,14,78,77,16,99,39,89,33
90 1 8 98,7,1,74,22,77,14,37,48,30,12,10,55,80,50,58,44,41,94,3,18,5,99,72,16,29,36,42,52,13,51,6,86,81,46,11,71
91 0 3 28,13,2,3,47,27,86,40,91,15,61,79,77,88,56,4,98,52,82,38,69,54,19,17,41,33,46
92 1 2 3,81,33,41,7,95,43,19,86,31,80,84,24,51,40,1,12,93,96,66,35,47,55,91,30,28,57,42,37,71,48,97,75,52,6,67,27,62,92,65,54,73,63,4,49,59,87,32
93 1 4 35,39,49,59,61,69,75,2,84,76,40,77,52,86,25,41,90,23,31,73,7,95,67,99,32,51,8,98,29,0,97,47,82,21,53,27,30,68,83,17,10,13,44,48,28
94 0 3 14,96,40,78,67,69,24,92,52,76,30,55,13,36,19,22,90,66,58,61,38,39,12,46,11,80,82,25,74,73,16,72,95,3
95 0 2 88,52,79,57,77,92,71,46,31,1,30,62,15,90,13,27,98,41,35,84,28,38,66,44,68,75,16,12,26,34
96 0 9 50,64,38,10,74,54,84,82,67,23,5,80,48,71,56,28,30,42,61,31,99,78,2,72,83,24,25,58,77,65,44,14,46,15,18,43,7,89,66,62,33,3,81,96
97 0 8 51,67,0,60,63,34,40,4,69,49,78,80,58,11,1,97,81,82,90,64,59,10,37,65,70,57,9,52,16,83,47,12,94,53,24,17,6,14,62,71,36,95,93,38,29,61,66,99,48,18,31,26
98 1 10 41,14,70,82,69,27,9,64,79,47,60,0,5,57,34,94,3,84,22,76,72,28,92,16,74,86,73,77,20,53,40
99 1 6 38,91,92,19,47,70,83,21,15,93,9,33,81,48,39,97,42,73,4,72,12,34,96,54,18,80,36,8,11,86,20,63,60,24,90,58,82,67,78,98,84,3,87,10,23,64,59,1,29,14
