0 0 5 37,28,64,52,75,6,92,39,47,17,65,93,87,0,91,38,63,59,53,8,20
1 0 1 59,7,75,74,2,97,38,17,24,30,81,13,33,28,56,69,22,35,79,50,67,76,72,53,19,61,9,36,37,83,84,55,26,93,86,52,4,18,27,87,20,12,68,78,89,6,21,49,5,85,82,34,57,46,39,10,42,60,95,11,98,23,32,77,54,91,48,31
2 1 2 66,52,0,28,26,6,61,91,88,39,8,24,75,68,54,72,67,22,11,4,37,95,9,62,3
3 0 8 10,66,57,92,89,63,23,4,51,11,20,98,86,71,8,55,50,6,31,43,54,65,53,84,67,90,39,34,91,25,85,7,29,96,80,13,64,0,59,69,99,60,5,73,27,49,15,93,72,81,35
4 1 2 52,3,79,73,39,82,61,33,91,9,76,49,14,15,92,57,28,59,29,30,65,27,23,83,13,45,78,24,0,37,40,10,25,7,87,93,18,85,74,60,67,68,90,84,44,72,70,26,43,98,19,54,34,71,46,41,42,53,38,66,86,12,69
5 1 1 93,49,33,82,53,59,14,65,72,22,18,75,58,63,61,26,90,78,30,89,76,54,10,17,80,50,37,5,88,11,3,86,41,56,31,4,94,21,29,1,87,36,23,83,67,98,62,44,51,79
6 0 1 25,39,5,67,49,48,33,17,98,52,68,95,87,65,70,76,46,8,31,4,94,58,88,43,19,18,83,71,97,91,75,66,29,21,7,60,85,38,12,34,20,50,15,27,37,3,6
7 0 7 61,76,7,38,89,65,17,12,31,23,67,92,47,59,90,46,10,28,87,71,27,91,68,13,21,1,79,77,36,74,15,50,43,41,22,6,53,4,83,48,93,20,86,66,57
8 1 10 76,84,11,47,21,70,64,20,73,27,69,94,39,5,35,6,67,54,0,85,95,62,45,71,4,96,14,38,13,44,92,53,1,31,3,12,56,80,7,72,23,42,28,55,77,17,57,26,22,88,41,87
9 1 7 91,19,52,18,73,87,38,69,81,23,13,74,42,61,92,65,53,85,1,45,11,96,78,97,39,72,15,33,12,40,27,66,16,95,9,43,29,26,2,86,30,47,3,55,62,41,6,36,79,71,46,37,10,17,57,83,70,50,89
10 1 0 74,44,97,76,54,69,10,98,77,4,83,99,58,67,31,92,85,30,75,60
11 0 6 77,73,60,30,6,57,66,29,39,28,71,89,47,62
12 1 7 70,66,77,50,40,76,27,45,68,16,39,99,21,43,19,37,8,91,41,69,10,80,11,93,52,44,42,83,84,92,31,9,58,56,73,78,35,59,38,36
13 1 1 51,99,44,14,69,28,0,42,7,50,24,6,25,40,78,71,30,19,56,35,55,76,26,87,15,98,61,43,77,11,17,75,39,74,47,48,54,53,8,12,4,2,86,59,60,10,18,96,64,32,83,79,3,84,20,21,31,46,33,93,67,66
14 0 5 28,30,38,82,87,44,50,27,21,5,53,60,16,40,35,52,86,51,0,1,85,96,62,78,43,89,69,91,97,34,24,67,95,29,19,14,41,83,94,59,18,55,75,4,25,64,23,98,54,68,46,22,17,56,79,15,2,39,47,12,58,49
15 1 6 77,1,61,75,18,82,46,39,60,12,20,87,16,8,71,69,41,95,4,58,57,3,44,74,90,99,40,35,29,2,85,80,11,62,78,31,50,22,79,70,96,32,28,36,17,7,86,25,63
16 0 5 5,15,31,43,69,55,36,80,86,6,72,92,23,57,59,77,97,30,74,76,50,48,78
17 1 9 19,38,70,17,28,18,96,68,20,87,92,16,49,72,31,3,66,24,52,75,36,12,21,6,8,71,98,32,53,4,67,91,54,90,7,11,55,46,42,0,48,29,78,62,93,57,34,47,13
18 0 0 52,64,74,37,32,7,69,86,80,93,42,30,58,78,38,46,73
19 1 10 75,25,94,13,80,28,47,8,15,0,53,21,34,31,88,7,42,33,10,19,81,1,86,65
20 1 0 94,39,4,96,58,70,73,61,84,64,31,60,55,85,3,89,97,66,41,17,20,77,78,93,71,28,95,92,72,51,90,33,25,49,44,52,16,11,88,91,45,18,56,81,83,38,47,15,34,9,99,63,2,50,5,79,7,46,69,30
21 1 3 73,71,91,42,49,82,96,31,47,9,29,78,98,21,75,56,55,6,57,38,86,66,35,89
22 0 5 80
23 0 4 8,52,88,40,0,42,73,54,68,85,61,33,14,1,95,12,65,23,30,32,93,9,16,26,80,29,97,57,39,81,38,28,79,34,99,83,66,4,55,13,17,19,98,47,62
24 0 6 53,65,36,32,61,73,89,26,27,41,17,7,45,66,33,91,10,48,12,39,35,50,75,15,60,44,69,37,95,34,52,0,58,86,64,74,46,87,62,6,29,19,5,4,70,78,18,57,80,51,43,25,93
25 0 0 55,87,73,79,90,46,77,26,30,71,81,65,88,5,69,61,66,64,41,28,68,74,93,50,39,57,24,37,33,78
26 1 7 56
27 0 8 94,9,98,74,73,66,59,50,22,0,24,40,79,32,44,76,29,11,49,7,43,5,47,10,30,96,12,38,48,31,23,54,72,70,16,86,3,68,67,60,14,46,1,45,84,37,71,36,83,81,21,19,99,62,56,57
28 0 0 92,36,46,56,66,26,76,53,25,40,50,61,21,16,43,99,45,84,20,64,24,49,35
29 0 3 34,92,88,25,74,98,1,57,29,45,62,41,16,21,14,65,38,40,66,82,12,73,94,91,79,30,9,61,42,69,95
30 0 5 38,53,18,86,0,36,46,55,26,51,88,44,2,67,50,10,62,93,97,74,49,83,43,85,7,87,60,34,56,23,69,61,8,63,72,45,37
31 1 7 11,25,66,77,39,35,94,8,9,49,61,14,24,88,91,54,89,15,19,38,34,98,83,20,73,63
32 0 2 51,72,61,56,62,82,36,52,42,1,97,76,96,24,41,60,9,80,67,49,32,27,21,17,30,55,39,26,20,44,18,12,71,46,34,16,38,69,7,65,35,22,19,14,64,79,53,4,85,0,48,6,75,88
33 0 10 80,66,53,33,4,87,59,60,77,97,73,62,74,54,19,70,42,78,5,63,16,18,30,13,79,94,41,50,8,72,96,81,92,47,52,68,34,48,23,57,58,55,28,91,45,29,9,43,12,49
34 0 2 97,53,26,33,25
35 1 5 36,18,40,47,87,3,70,54,82,15,95,64,34,48,63,93,60,38,24,91,4,13,22,20,45,69,1,29,61,81,28,65
36 1 5 31,96
37 0 8 89,83,36
38 1 1 63,66,9,27,89,79,22,4,64,49,41,7,28,80,21,16,31,51,76,96,97
39 1 7 55,23,97,92,60,10,99,5,31,59,35,89,25,94,91,93,58,56,76,88,14,15,13,87,17,54,71,24,96,44,6,12,70,69,49,4,67,0,2,26,38,7,27,80,74,82,9,50,79,30,57,21,85,11,68,47,72,19,66
40 0 0 99,82,60,65,70,0,47,1,72,41,13,18,12,44,43,2,91,68
41 0 9 9,90,49,16,29,91,95,60,67,87,26,10,1,28,52,58,64,24,80,41,93,54,25,72,18,31,97,62,0,70,43,57,61,8,82,33,38,35,39,99,20,89,51,27,47,86,44,13,45,48,11,92,3,46,7,65,68,71,14,22,17,94,19,69
42 0 1 64,19,83,15,13,30,56,66,92,73,49,17,43,22,53,41,0,78,35,76,79,55,54,82,93,27,9,51,71,48,80,58,11,88,84,72,42,95,70,40,3,33,4,21,34,97,91,61,98,96,38,65,10,77,37,7,18,44,87,14
43 1 10 96,97,91,32,38,40,88,98,15,86,66,31,51,28,78,47,80,83,2,68,19,11,30,25,53,57,9,50,34,43,0,24,14,90,77,46,49,18,58,4,13,95,21,10,54,29,72,76,82,99,6
44 1 6 75,96,80,41,42,93,10,1,21,39,40,22,63,6,17,15,73,99,13,77,2,79,30,48,55,16,44,5,46,72,85,34,43,37,68,28,45,94,0,8,86,31,7,26,76,18,67,95,29,35,59,84,71,51,32,47,3,87,12,20,9
45 1 3 57,24,46,7,2,22,71,36,16,38,59,83,40,74,67,35,5,86,82,89,50,31,42,17,85,94,18,51,30,65,0,95,9,29,21,78,1,72,26,15
46 1 4 28,1,69,50,87,57,40,37,42,39
47 0 8 31,73,51,79,67,35,53,6,76,78,60,68,46,99,86,82,72,93,0,41,54,49,58,90,15,74,71,47,97,40,11,91,32,17,23,59,16,89,42,10,14,43,7,52,3,45,62,92,25,8,18,24,64,75,1,30,38,63,57,50,77
48 1 0 29,61,79,34,52,27,65,10,57,75,85,41,15,93,51,32,89,47,68,3,6,9,48,94,44,53,31,46,39,42,66,16,67,88,78,45,69,7,72,36,71,73,38,76,20
49 0 3 55,25,4,85,60,34,89,33,47,10,81,94,3,27,23,12,58,35,11,51,13,5,87,68,63,41,39,46,19,69,57,95,0,73,79,15,32,30,83,36,66,54,76,21
50 0 0 80,20,57,85,1,53,36,22,58,5,97,67,93,34,92,90,79,35,21,45,59,3,91,23,69,99,46,73,7,89,74,84,14,9
51 1 5 5,90,25,29,21,10,51,38,99,75,44,16,49,52,93,31,97,60,87,98,46,59,69,42,58,50,4,55,30,17,77,43,72,47,96,78,26,8,53,28,15,66,61,86,88,37,70,63,2,73,12,56,67,41,13,33,71,3,34,39,6,92
52 0 3 78,2,13,41,66,35,89,90,55,69,48,33,32,62,50,72,79,40,96,49,43,17,93,36,67,91,27,16
53 1 1 72,59,84,22,65,90,94,10,68,34,20,12,3,85,82,49,92,45,23,13,47,19,64,88,56,7,69,43,46,6,61,18,93,40,48,37,70,27,77,8,78,14,42,96,28,25,97,99,0
54 0 10 92,47,34,4,61,44,3,49,69,80,25,89,57,78,56,10,93,33,24,55,82,41,1,43,5,73,48,85,66,62,15,21,54,90,27,95,60,40,7,88,38,46,19,91,39,51,79,26
55 1 10 59,46,23,77,13,22,31,6,72,53,64,62,35,44,42,97,39,87,49,57,85,9,32,81,54,67,24,47,45,68,4,65,38,52,61,55,60,29,43,70,90,10,82,71,14,33,36,0,50,75,51,21,48,86,30,76,25
56 0 5 63,60,56,70,30,52,94,40,87,32,67,64,23,3,82,5,78,13,58,33,24,59,41,31,46,17,88,91,37,48,53,55,49,73,4,84,81,7,22,50,97,18,45,0,21,75,27
57 0 10 17,9,49,3,56,77,76,84,0,58,45,79,60,69,92,82,26,16,99,30,24,41,5,13,31,12,42,71,61,89,25,44,66,19,62,86,47,97,81,40,32,53,50,78,34,27,14
58 0 0 79,40,25,6,14,85,48,60,99,78,16,83,84,61,11,68,47,37,9,92,63,36,26,13,59,50,45,70,74,94,93,91,34,71,4,24,54
59 1 1 3,74,87,34,94,57,44,69,73,66,37,71,99,65,6,39,53,95,22,12,35,33,1
60 0 0 52,97,90,2,68,58,18,1,33,62,42,92,76,34,21,19,50,99,69,64,10,83,15,29,16,13,86,23,98,55,6,9,11,38
61 1 7 84,39,20,55,65,42,52,76,29,95,26,38,72,60,0,48,21,4,54,56,77,15,23,11,12,87,86,88,6,30,7
62 0 6 45,28,76,97,90,12,54,10,9,78,55,71,42,5,99,29,43,49,31,69,18,86
63 1 1 93,98,69,2,86,35,43,87,46,38,34,56,51,32,8,90,64,24,59,16,47,67,62,29,10,54,23,7,92,18,4,85,79,14,26,70,99,48,5,97,68,3,6,20,11,76,74,57,60,50
64 1 5 68,53,3,69,46,70,10,79,28,40,82,75,80,65,96,91,43,85,99,4,83,45,90,34,30,92,60,62,23,11,95
65 1 6 82,21,55,32,65,93,19,44,43,64,27,51,74,75,35,10,31,95,89,25,61,97
66 1 6 63,25,17,31,77,16,41,42,49,22,30,78,82,50,40,67,83,3,8,64,36,59,62,69,87,94,54,32,13,14,15,43,91,55,51,47,65,44,20,57,79,61,52,9,34,23,68,35,48,56,11,99,19
67 1 5 10,42,55,77,62,7,52,43,63,81,15,91,57,13,74,66,39,11,64,98,93,65,89,38,90,79,94,72,95,8,46,60,73,18,82,37,45,2,71,51,9,78,58,83,3,44,87,92,40,34,50,49,27,24,12,1,99,80,33
68 0 4 99,6,86,57,31,7,53,64,25,62,74,41,23,91,82,10,76,42,20,1,35,30,55,94,85,61,34,12,49,27,37,8,47,78,22,87,95,65,0,88,84,48,28,40,93,3,51,26,90,98,56,50,13,67,70,96,69,39,33,32,14,16
69 1 9 92,40,86,38,0,79,71,20,52,5,68,42,80,29,15,84,75,24,19,28,16,98,35,48,43,55,72,77,4,21,87,89,82,46,91,62,27,56,1,7,61,69,37,99,90,67,51,13,49,93,25,66,63,31,96,47,2,97,23,33,18,11,50
70 1 10 84,58,29,28,89,41,65,59,57,54,82,39,71,8,67,46,61,48,83,68,95,27,12,35,24,38,85,37,3,92,70,33,49,1,0,17,34,30,64
71 0 5 33,46,11,0,62,96,78,76,64,38,97,56,7,72,80,47,1,21,23,88
72 0 4 0,82,65,16,63,87,47,52,53,13,8,96,24,29,33,3,72,25,39,49,60,34,61,95,64,21,62,18,58,7,23,10,81,80,86,75,11,36,67,51,31,94,38,37,42,84,56,83,45,4,41,48,77,91
73 1 3 89,43,61,44,59,37,74,99,45,78,53,83,8,97,16,72,49
74 0 2 70,43,99,75,34,72,7,19,11,42,57,12,63,31,78,62,93,76,2,65,38,91,56,60,98,21,16,6,90,89,94,46,45,33,17,86,73,13,59,29,64,8,39,96,83,32,79,84,14,40,9,77,69,54,85
75 1 10 21,62,10,61,51,91,96,92,6,94,0,5,64,79,34,52,88,38,23,69,4,35,76,15,97,67,98,37,14,45,82,57,73,59,68,80,72,77,66,65,71,55,30,99,47,40,9,70,53,18,1,83,41,25,27,7,46,43,56
76 1 0 31,71,15,93,58,59,21,62,84,22,2,91,20,66,34,57,72,82,11,52,36,41
77 1 4 17,48,89,71,62,75,83,93,35,57,30,26,22,33,4,96,8,59,63,13,78,5,69,64,12
78 1 4 11,41,56,67,77,39,58,46,81,50,43,29,84,31,12,71,4,99,6,73,79,25,61,2,30,57,13,22,48,92,49,68,9,19,62,38,36,20,88,95,82,27,18,53,32,63,23,76,5,96,97,64,44,98,55,87,0
79 0 9 71,22,11,51,89,95,6,62,17,93,18,82,46,32,63,55,81,25,74,77,66,60,94,34,10,15,20,57,2,0,73,37,23,21,56,48,40,96,58,4,85,69,53,52,8,76,30,29,79,26
80 0 2 57,22,94,29,31,90,83,63,16,50,15,78,64,59,0,62,52,56,85,9,45,92,95,73,21,84,86,33,89,97,17,68,91,34,65,24,47,2,93,12,75,32,88,28,40,8,79,10,39,87,98,48,36
81 0 7 93,63,70,16,56,90,11,99,10,35,3,98,61,17,60,88,66,19,40,94,7,15,85,95,52,57,48,47,21,64,23,58,71,25,80,49,69,31,8,0,44,54,73,4,83,13,20,33,5,2,65,1,46,97,38,78,62,32,28,79
82 1 7 27,52,7,96,37,54,12,73,9,72,17,84,34,97,29,43,60,32,38,75,63,80,31,19,78,81,36,41,67
83 0 5 0,14,55,3,15,22,71,34,95,86,91,78,7,39,56,2,94,87,81,59,67,43,27,80,4,11,29,24,18,83,89,12,35,51,76,96,54,42,33,69,74,44,6,21,68,9,32,31,99,19,70,30,8,28,13,1
84 0 10 80,81,96,87,13,72,62,17,46,29,89,45,59,47,51,75,0,14,90,1,6,94,83,88,54,52,7,95,20,48,91
85 0 4 70,85,47,2,65,14,89,25,74,61,52,79,68,99,91,32,44,28,21,66,35,98,41,36,22,0,63,97,94,37,77,17,72,26
86 0 4 8,69,66,14,72,34,23,38,77,74,37,22,82,65,90,43,5,11,1,19,53,0,7,20,27,57,21,71,15,46,40,75,33,81,60,29,26,59,62,49,96,42,80,97,44,50,2,6,52,67,68,94,24,78,41,31,55,85,87,25,12,54
87 0 7 70,17,18,7,33,37,55,68,79,29,39,49,83,4,40,82,23,95,47,80,1,48,92,56,64,75,16,9,85,62,81,32,34,15,69,87,71,77,19,31,20,89,98,59,84,24,38,44,21,91,54,74,78
88 0 7 17,75,96,92,3
89 1 0 80,69,54,78,28,79,52,98,84,61,60,67,10,88,14,1,26,21,68,94,90,65,16,74,56
90 0 2 57,15,22,65,27,75,96,62,6,18,9,79,95,52,11,59,82,99,74,38,37,90,71,84,23,32,7,87,25,35,17,48,16,42,78,12,4,63,68,97,49,20,29,83,47,67,88,43,69,36,98,51,10
91 1 8 92,64,82,16,26,34,94,53,6,75,95,91,86,68,49,39,57,41,98,33,35,14,69,43,76,8,23,65,56,3,61,10,13,81,2,37,96,38,55,80,71,40,60,51,89,29,84,77,48,47,59
92 0 7 78,43,15,17,79,30,37,9,66,16,12,4,75,72,44,39,94,98,27
93 0 9 16,0,96,12,28,43,4,79,22,84,17,34,63,71,14,41,33,56,48,69,31,24,95
94 0 3 62,92,65,3,94,66,31,59,54,23,86,53,91,67,96,6,81,64,49,52,27,13,93,10,69,26,51
95 1 3 46,7,77,82,34,19,37,41,81,89,74,3,23,67,17,98,44
96 0 0 23,86,47,54,50,28,14,80,22,4,72,89,94,92,98,13,5,26,44,52,31,36,81,97,65,60,58,40,25,18,10,1,76,79,62,15,29,64,3,7,24,9,33,55,59,45,32,87
97 0 10 19,81,24,60,64,70,83,31,2,17,51,89,32,77,12,82,92,36,11,41,29,58,43,20,22,49,5,95,94,66,56,75,71,26,72,21,53,67,40,50,73,90,52,68,45,35,65,18,46,62,38,63,47,59,15
98 1 4 21,23,6,32,93,70,64,60,71,80,30,20,43,99,89,2,52,51,34,10,74,49,45,18,90,94,82,92,57,5,58,98,67,9,14,61,65,55,24,87,63,68,0,7,75,44,35,38,1,81,96,19,22,83,78,53,37
99 1 1 2,34,8,45,21,60,38,90,98,92,54,64,0,47,57,75,59,61,68,66,35,80,3,78,30,51,22,95,85,70,58,79,20,27
