0 1 1 2,7
1 0 1 5,9
2 0 2 8
3 1 4 1,2
4 1 3 0
5 1 0 9,4
6 1 5 7,9
7 0 7 3,0
8 0 4 9
9 0 0 7,3
