0 0 35 36,18,66,10,60,23,82
1 0 42 27,65
2 1 72 28,8,44,58,66
3 0 6 22,95,86,73,11,56,40,88,7,89,15,96,44
4 0 57 87,34,69,73,38,25,89,50,84,82,4,99,66,59,32,46,97,13
5 1 85 59
6 1 25 17,25,15,48,88,89,70,99
7 1 66 2,41,14,8
8 1 18 84
9 0 2 2,52,58,50,95,41,38,85,24,90,99,49,89,25
10 1 86 6,60,31,24,61,32,64,82,49
11 1 42 43,13,9,66,19,71
12 1 58 91,55,2,5
13 0 86 78,33,52,83
14 0 3 30,35,84,0,7,23,37,3,97,89,56,54,16,33,40,41,92,98
15 0 11 41,67,93,85
16 0 47 20,68,21,45,56,79,63,38,28,66,46,27
17 0 39 6,0,20,29,33,16,87,83,91,74,86,90,1,60,54,52,24,30
18 0 64 18,6,39,92,69,81,89,4,23,94,0
19 1 77 93,32,26,99,61,56,83,58,76,9,87
20 1 93 37,86,10,56,47,58,54,11,55,75,32,45,52
21 1 93 7,1,26,45,28,48,27,87,3,30,49,16
22 0 70 44,70,19,3,40,35,72,58
23 1 38 91
24 0 49 83,4,64,69,84,57
25 0 25 71,37,3,75,15,50,58,65,14
26 1 92 77,61,54,33,64,92,81,60,34,20,44,80,31,79,96,63,18
27 0 15 47,14
28 1 10 99,68
29 0 40 79
30 0 19 88,18,85,2,50,80,46,92,11,39,47,90,65,9,82,48
31 1 39 73,80,24,7,33,78,32,74,82,2
32 1 53 12,17,87,72,56,47,27,55,63,84,10,6
33 0 69 81,72,10,17,11,27
34 0 84 91,75,14,36,58,51,35,60,86,5,78,82,62,48,83
35 0 27 50,21,76,22,44,25,43,5,2,91,27,15,8,99,17,29
36 0 92 5,90,91,71
37 1 46 32
38 1 71 76,96,65,42,38,21,16,77,8,61,78,51
39 0 23 52,25,27,80,99,7,97,9,67,6,96,15,17,30,22,43
40 1 56 90,46,60,26,70,30,75,22,9,91,4
41 1 40 46,57
42 0 27 5,2,53,63,79
43 1 86 52,57,46,10,7,31,79,47,55,56,58,35
44 0 2 45,37,38,58,59,65,46,81,32,9,95
45 1 73 67,15,51,23,20,0,32,73,30,95,22,34,97,69,72,89,7,54
46 0 12 64
47 0 57 63,36,62
48 0 97 10,80,27,74,14,26,84,15,72
49 0 49 33,52
50 1 72 4,81,17,51,35,47,23,12,42,99
51 0 96 8,17
52 0 57 28,66,30,99,64,58,56,22,60,19,13,47,70,29,16,68,82,37,84,73
53 0 48 49,40,86,50,18,13
54 1 33 38,39,15,77,89,87,5,73,47,28,49,29,61,17,6,85,1
55 0 23 64,86,54,2,13,76,15,1,24
56 1 1 80,59
57 0 34 77,16,7,65,44,89,24,58,53,32,49,20,36,14
58 0 54 25,5,87,96,39,6,0,92,67,66,10
59 0 75 62,47,53,2,99,88,77
60 1 46 66,70,92,65,68,48,64,98
61 1 30 63,88,65,44,40
62 1 90 74,3,69,8,83,46,50,82,7,9,17,16,94,59,57,53,78
63 0 11 64,90,29,93,96,51,68,88,60,84,85,97,12,45,67
64 0 82 45,33,78,58,72,40,42,57,46,56,93,9,92,8,75,24
65 1 7 20,7,53,54,36
66 0 90 72,11,92,91,70
67 1 71 51,95,90,68,79,34,43,80,74,4,72,89,62,23,56,73
68 1 8 71,99,35,22,51,64,82,77,66,12
69 0 52 49,68,99,83,13,18,6,36,84,10,55,2,22,64,39,71,56
70 1 95 35,0
71 0 8 33,36,48,44,34,73,98,41,54,70
72 1 29 5,29,21,40,32,13,55,14,28,60,41,86,85,81,37,98,8
73 1 48 18,13,86,65,44,16,11,60,49
74 0 51 73,35,96,77
75 1 100 89,61,34,46,84,10,23,60,53,6,29,50,56,17,77
76 1 68 68,92,53,26,18
77 0 25 1
78 0 5 29,15,50,94,57,37,56
79 1 36 1,84,21,60
80 1 64 86,77,40,47,44,26,15,92,90,24,64,35,57,41
81 0 41 73,81,14,70,77,27,86,5,49,6,52,33,42,34,94,61
82 1 24 23,12,30,45,88
83 1 82 58,51,81,7,95,63,50,36,4,75,94,32,60,1,72,24,16,12,55
84 1 12 91,81,27,57,52,28,96,89,24,79,92,0,99,11,46,49,31
85 0 54 97,16,5,38,56,12,91,92,7,85,20,87,41,63,22,28,17
86 0 77 92
87 1 67 76,90,72,55,5,42,85,54,91,86,70,7,83,9,14,21,57,62,3,25
88 1 53 48,26,9,67
89 0 86 8,79,26,21,95,36,28,37,55,83,35,40,67,20,61
90 1 50 75,87,58,7,53,52,43,14,38,11,79,20,34,13,10,0,39
91 1 76 60,83,50
92 0 11 32,36,90,68,30,99,65,95,7
93 1 72 97,27,99,45
94 1 74 32,73,62,41,47,2
95 1 59 53,60,22,30,58,40,26,0,34
96 1 5 14,37,11,51,6,3,74,70,9,19,48,24,55,38,0,65,41,53
97 1 82 8,40,9,82,74,79
98 1 19 40,48,58,97,12,99,59,69,6,66,17,89,86,94
99 1 65 24,70,25,63,3
