0 0 3 7,5,2,9,1
1 0 1 6,9,8
2 1 0 0,3,5,4,9,2
3 0 3 5,4,9,8,3,6,0
4 0 7 9
5 1 7 2,1,4
6 1 2 6,5,1,3,4
7 0 2 5,6,0,4,3,1
8 1 3 9,3,5
9 1 7 5,9,4
