0 0 60 35,31,49
1 0 72 6,15,31,3,61,70
2 0 5 84,9
3 0 48 4,9,58
4 0 64 73,46,2,66,65,8,4
5 1 17 23,36,48
6 0 41 49,27,93,6,96,5,79
7 1 70 95,29,1,30,36,33,0,70,56,23
8 1 1 60,40,92,79,51,76,43
9 0 57 56
10 0 92 0,36,12,24,43
11 0 77 79,62,46
12 1 95 35,11,47
13 0 94 13,64,10,97,80,5,51,27
14 1 83 75,52,36,16,70,40,87
15 0 39 44,84,58,32
16 0 29 71,85,8,50,81,49,98,64
17 1 25 70,29,34,11
18 0 92 58,22,88
19 1 45 86,60,52
20 1 82 23,94,99,17
21 1 87 41,9,95
22 0 38 66,6,61,41
23 0 45 2,62,58,57,66
24 0 21 48,72,65,5,32,94
25 1 19 88,26,48,28,99,12,34,79
26 1 53 74,30,51,33,21
27 0 10 82,67,1,54,25,73,63,34,21
28 0 14 4
29 0 37 38,87,29,33
30 0 94 23,53,28
31 0 66 64,66
32 1 11 66,35,31,11,53,23,40,48,4
33 0 64 97,27,52,83,70,40,34
34 0 35 54,42,41,33,39,55,26,9,32
35 1 60 78,63,43,21,66,74,98
36 1 75 50,76,27,62,23,81,55
37 1 29 28,16,26,95,13,88
38 0 30 51,57
39 1 73 86,66,49,46,41,14
40 0 14 38,33
41 0 8 17,85,22
42 1 4 5,13,48,35,46,53,50,32
43 0 76 40,75,31,59,87,62
44 0 88 31,25,58,23,29
45 1 13 21,85
46 0 23 49,15,52,63,94,97,2,62
47 0 82 38
48 0 85 18
49 1 11 97
50 0 19 78,81,24,63
51 0 62 35,81,58,86
52 1 97 50,98,81,39,49,13,24,32
53 1 94 28,44,15,85,18,1,79,37,5,49
54 1 12 44,28,23,86,10
55 0 20 82,11
56 1 51 1,54,15,46,87,5
57 0 39 41,37,28,42,87,74,56
58 1 61 89,48,97,27,18
59 0 30 19
60 1 30 73,64,46,12
61 0 53 51,43,12
62 0 4 54,4
63 0 15 17,55,81,80
64 1 83 17,83,77,24,2,78
65 1 5 80,1,99,14,60,33,48,0,56,18
66 0 2 45,84,86,64,3,7,49,32
67 0 53 21,63,79,35,34,72
68 0 58 4
69 0 96 88,57,36,85,28,43
70 0 8 91,70,43,18,58
71 0 2 17,66
72 0 88 33,65,52,35,88,49
73 1 56 0,52,36,51,50,43,38,25
74 1 56 30
75 1 98 15
76 1 89 32,66,99,53,89
77 0 36 29,91,33,93,23,59,30
78 1 77 34,86,52,33
79 1 59 32,54,18,69,39,73
80 0 3 43,82,97
81 1 56 68,66,69,90,6,94,81,48
82 1 6 15,91,33,34,7,81
83 1 86 38,71
84 0 38 38,36,30
85 0 26 49
86 0 43 40,43,62,67,21
87 0 83 90,69,16,37,40
88 0 19 10,4,25,40,89,17,87,35
89 0 7 91,83,46,45,65
90 1 10 0,21,24,20,12
91 1 87 51,83,12,45
92 0 55 43,94,68
93 1 20 70,65,96,69,54
94 0 9 24,99,62,75,55,45
95 0 45 1,19,70
96 1 5 5,44,54,55,48,53
97 0 56 71
98 0 81 96,0,8,83,55,74,44,85,6
99 1 52 58,13,44,87,41,52,25,69,54
