0 1 1 4,5,3,7,9
1 0 7 4,1,7,8
2 1 3 5,1,3
3 1 10 5,3,7,8,4
4 0 4 6,9,2
5 1 7 0,7,6,9,4
6 1 9 5,3,1,4,7
7 1 0 3,4,2,7,8
8 0 1 7
9 1 0 0,3,5,2,9,1,7,8
