0 1 4 1,3
1 0 3 0,2
2 1 2 1,5
3 0 1 4,6
4 1 0 0,7,8
5 1 1 1,7
6 1 2 7
7 0 3 6,8
8 0 0 5