0 0 4 1,3
1 1 0 2,3
2 0 3 4
3 1 1 0,5
4 1 2 1,7
5 0 6 3,6
6 1 8 4,7
7 0 5 6